A357ED7D37
99E8178799
9815725499
257D69A699
9D6EA69D4F
85792B2B87
A799854A79
9811356986
9A7ECA727E
8681568686
